6,16
  # ##  # ## # #
# #    #X# #### 
 ##   # ## # ## 
 # ## # ## ###  
###   ## ## # ##
 # ##   ###   ##
