12,32
# ## ####  # ###    ###  #   ## 
   ### #######     ## #      #  
##   ###   #   # ## # X  # ###  
  # ##   #  ###    # #######   #
 # #  ### ###   #    # #      ##
   ## ## ##  #  #  #####  ## # #
# ### ####### #  #   # ######   
  ###       ## #   # #  ###  # #
#  ###     ###     # # #   ## # 
 ###  ## # ####   # # #    #  ##
 #   ##  #  #   #### ## # ###   
## ## #### #    #     #  ## #   
